##########
#A   #   #
#  # # # #
#  # # # #
#        #
#  ##### #
#        #
#  #   # #
#  #   #B#
##########
