#######
#S    #
#   # #
# # # #
#   # #
#    G#
#######